111111111111111111111111111111
1P0000010000000000000000000001
100011101000011000000000000001
100000001000001000000000000001
100000001000001000000000000001
100001111000001000000000000001
100000000000001000000000000001
10000000000000100000C000000001
100000011100001000000000000001
100000000100001000000000000001
100000000111111000000000000001
1000000000000000000000000000E1
111111111111111111111111111111