1111111
1PE0001
110C0C1
10C0001
1111111