111111
1P0C11
110001
11C0E1
111111