1111111
1P00001
100C0C1
10C00E1
1111111